0 0 0 0 0 0 0 0 0 0 0
0 1 2 3 4 5 4 3 2 1 0
0 2 3 4 5 4 3 2 1 2 0
0 3 4 5 4 3 2 1 2 3 0
0 4 5 4 3 2 1 2 3 4 0
0 5 4 3 2 1 2 3 4 5 0
0 4 3 2 1 2 3 4 5 4 0
0 3 2 1 2 3 4 5 4 3 0
0 2 1 2 3 4 5 4 3 2 0
0 1 2 3 4 5 4 3 2 1 0
0 0 0 0 0 0 0 0 0 0 0