0 0 0 1 1 0 1 1 0 0 0
0 0 1 2 0 0 0 2 1 0 0
0 1 2 3 2 0 2 3 2 1 0
1 2 3 4 3 0 3 4 3 2 1
1 2 3 4 4 4 4 4 3 2 1
1 2 3 4 3 0 3 4 3 2 1
0 1 2 3 2 0 2 3 2 1 0
0 0 1 2 0 0 0 2 1 0 0
0 0 0 1 1 0 1 1 0 0 0
0 0 0 0 0 0 0 0 0 0 0
