0 0 1 1 1 1 1 1 1 0 0
0 1 1 5 5 1 5 5 1 1 0
1 1 5 4 4 5 4 4 5 1 1
1 5 4 3 3 4 3 3 4 5 1
1 5 4 3 2 3 2 3 4 5 1
1 1 5 4 3 2 3 4 5 1 1
0 1 1 5 4 3 4 5 1 1 0
0 0 1 1 5 4 5 1 1 0 0
0 0 0 1 1 5 1 1 0 0 0
0 0 0 0 1 1 1 0 0 0 0
0 0 0 0 0 0 0 0 0 0 0